1111111111111111
1001000000000001
1000010111000001
1000111000000111
1111111111111111