1111111111111111
10010000000C0001
1000010111000001
1P0011E0C0000111
1111111111111111