1111111111111111111
10010000000C0000001
1000010111000000C01
1P0011E0C0000110011
1111111111111111111